11111111111111111111
1C100C10001000C000L1
10101000101011101101
1C0011101C000010C001
11101E00101010101011
10C01101100000001001
101000C0110111011101
1011011000010000C001
100C00110111C1101101
101110100C000100C101
100P10001101110111C1
10000C001E0000C00001
11111111111111111111