1111111111111111111111111111
100C000C1000C0000001000C00L1
1011110110111110110110111101
10010000C0100000100C1C000001
11C0011100E01110101110110101
10010C100011100000C00010C101
1011100010000010011110101101
101000111110101000C100001001
1P001000C0001C00100001C000E1
1111111111111111111111111111