1111111111111111111
1P00000000000000001
10000000000000C0001
10CC00CCC0CCC0CC001
10C0C0C0C0C0C0C0C01
10C0C0CCC0CCC0CCC01
10000000000000000E1
1111111111111111111