1111111111
1001001E01
1P01001101
1100L00C01
1111111111
